R 600 600


1111111111
1000000001
1000000001
1000000001
1000000N01
1111111111