R 600 480

NO textures/stone+wall-512x512.xpm

SO textures/Bricks_001.xpm


WE textures/true+seattle+ground+soil-64x64.xpm

EA textures/plaster474a.xpm

S textures/sprite_1.xpm

SKY textures/sky2.xpm

F 0,0,0

C 51,198,227

        1111111111111111111111111
        1000200000110000000000001
        1011000001110000002000001
        1001200000000000000000001
111111111011000001110000000000001
100000000011000001111011111111111
11110111111111011100000000011
11110111111111011110011110201
11000000110101011100000010001
10002000000000000000000W00001
10000000002000001101010000001
110000011101010111110211100111
11110111 1110101 100011000001
11111111 1111111 111111111111