R 1200000 800
NO   textures/Bricks_001.xpm
SO textures/clear+sea+water-512x512.xpm
WE textures/true+seattle+ground+soil-64x64.xpm
EA textures/wall+concrete+decoration-64x64.xpm


F  0 , 0 ,0
  
C  255,150,250  

S textures/sprite_1.xpm


111111111111111111111111111111
10000000001100000000000000000111
100110000011100000201100000011211
1021000000000000000010001111111111111
1111111110110000011100000000000001
1020000000110000011101111111111111
1111011111111100110000001000110001
111101111111110011000100100011000111
1100000011000S011000000120111110001
10000000020000000000000000000000000110
1000200000000000110000000000000000001
1000000000000200110101001000100002001
1100000111101011111011110011111111111
11110111 1110101 101111010001
11111111 1111111 111111111111
