R 900 600
NO textures/red+hot+fire+flames-512x512.xpm
SO textures/ice+and+snow+ground-512x512.xpm
WE textures/clear+sea+water-512x512.xpm
EA textures/plaster474a.xpm
S textures/sprite_1.xpm
F 232,232,210
C 70,7,16

        1111111111111111111111111
        1000000000110000000000001
        1011200001110000002000001
        1001000000000000000000001
111111111011000001110000000000001
1000000000110000011101111100011111
1111011111111101112000001000111
11110111111111011101010000001
110000001101010111000000100011
1000200000002000112000000000201
100000000000000011010100100001
11000001110101011111011200N0111
11110111 1110101 101111010001
11111111 1111111 111111111111
