 R 600 480
NO textures/ice+and+snow+ground-512x512.xpm
WE textures/clear+sea+water-512x512.xpm
SO textures/red+hot+fire+flames-512x512.xpm
EA textures/rocky+soil-512x512.xpm
S textures/sprite_1.xpm
F 122,122,122	
C 70,7,16

11111111111111111
10000000000000001
10002001200200111
10000000000001001
10200000200002001
10000000000000001
11100111100000001
10000000110000021
120000001110000111111111111111111
11000000000000000000000000000021111111111
10000000101120000000000000200000000000021 111111
10000020100100S00000000011000000110000111110001
11100011101100001110000000000001111200011100011
1200000000110000011101111100011111100000100000111111
111100011111000112000001000111   1111000000100000211
112000000111200110000001000111   111111111111111111
111111100111100011210100000011   
1100222001010100100000001000111
1000200000000000002000010000201
1200000010000000100101001000211
1100000111010120011101120002111
11200111 111010111111100010021
1100011111 110011  111111111111
1110022111 11111 
1111111111
