R 600 400
NO textures/wall_1.xpm
SO textures/wall_2.xpm
WE textures/wall_2.xpm
EA textures/wall_4.xpm
S textures/sprite_3.xpm
F 232,232,210
C 7,7,16

        1111111111111111111111111
        1000000000110000000000001
        1011000001110000002000001
        1001000000000000000000001
111111111011000001110000000000001
1000000000110000011101111100011111
1111011111111101110000001000111
11110111111111011101010010001
11000000110101011100000010001
10002000000000001100000010001
10000000000000001101010010001
11000001110101011111011110N0111
11110111 1110101 101111010001
11111111 1111111 111111111111
