
R 600 480

NO  textures/concrete+cement+wall-64x64.xpm
WE textures/stone+wall-512x512.xpm
SO textures/dark+parquet-64x64.xpm

EA textures/holey-cheese-64x64.xpm

S textures/pillar.xpm

SKY textures/sky.xpm


F 200, 210,100
  
C  100,200,250  

11111111111111111111111111111111
100000000000000000021111000000011
100000000111100000200001000020111
100000200100011000000121000000111
1111011111000100000000010000002211
1000000001100200000100010000000001
1111000100000000000200011111100111
1120000000E000000000020000100000111
101111121001101100000111000002000111
1111111111111111011111111111111111111
               1011
               101111111111
               100000000001
               100200000001
               100000000001
               111111111111