
R 600 600
F 220,100,0


NO  textures/ice+and+snow+ground-512x512.xpm
WE textures/concrete+cement+wall-64x64.xpm
SO textures/dark+parquet-64x64.xpm

EA textures/holey-cheese-64x64.xpm


  
C  255,255,250  

S textures/sprite_1.xpm

11111111
1200N021
11111111