R 1600 800

NO textures/stone+wall-512x512.xpm

SO textures/Bricks_001.xpm


WE textures/true+seattle+ground+soil-64x64.xpm

EA textures/plaster474a.xpm

S textures/pillar.xpm

SKY textures/sky4.xpm

F 0,0,0

C 51,198,227

        1111111111111111111111111
        1000000000110000000000001
        1011000001110000002000001
        1001000000010000000000001
111111111011000001110000000000001
100000000011000001111100111111111
11110111111111011100000000011
11110111111111011111111110201
11000000110101011100000010001
10002000000000001100000010001
10000000000000001101010010001
11000001110101011111011110N0111
11110111 1110101 101111010001
11110111 1111111 111111111111