R 750 500
NO     ./pictures/purple stone.png
SO ./pictures/bluestone.png
WE ./pictures/colorstone.png
EA ./pictures/greystone.png


F  0 , 0 ,0
  
C  0,0,50  

S ./pictures/pillar.png


111111111111111111111111111111
100000000011000000000000000001
100110000011100000201100000011
1021000000000000000010001111111111111
1111111110110000011100000000000001
1020000000110000011101111111111111
1111011111111100110000001000110001
111101111111110011000100100011000111
1100000011S00000110000 0120111110001
1000200000000000110000000000000000001
1000000000000200110101001000100002001
1100000111101011111011110011111111111
11110111 1110101 101111010001
11111111 1111111 111111111111
