R 600 500
NO     ./pictures/purple stone.png
SO ./pictures/bluestone.png
WE ./pictures/colorstone.png
EA ./pictures/greystone.png


F  0 ,90, 155
  
C  180, 50, 89

S ./pictures/pillar.png


1111111111
1000000001
1111001111
100000001
10011100N1
1111 11011
