R 600 500
NO     ./pictures/purple stone.png
SO ./pictures/bluestone.png
WE ./pictures/colorstone.png
EA ./pictures/greystone.png


F  0 ,0, 155
  
C  180, 50, 89

S ./pictures/pillar.png


1111111111
1000000001
1111111111
10000000S1
1001110001
1111 11111
